Ms, Ms, Aa, Ha, Aa, Ai, Ai, Aa^Fpa, Ha, Ha, Ai, Ha, Aa^Fpa, Ha, Ms, Ha, Ms, Ms, Ha, Ha, Ha, Ha, Aa^Fpa, Ha, Ha, Ha, Ha, Ha, Ai, Ha, Ha, Ha, Ha, Ms, Ms, Ms, Ha, Ms
Ms, Ms, Aa, Ha, Aa, Ai, Ai, Aa^Fpa, Ms, Ms^Xm, Ms, Ai, Ms, Aa^Fpa, Ha, Ai, Aa^Fpa, Ha, Ms, Ai, Ms, Ms, Aa^Fpa, Ha, Ha^Vhha, Ha, Ha, Ha, Ms, Ai, Ms, Ha, Ha, Ms, Ai, Ms, Ms, Ha
Aa^Fpa, Aa^Fpa, Aa^Fpa, Aa, Ch, Aa, Aa, Ww, Aa, Ms, Rd, Ha, Aa, Ms, Aa^Fpa, Ms, Ms, Ha, Ms, Ms, Ha, Ms, Ms, Aa^Fpa, Rd, Ai, Ai, Ai, Ai, Ai, Ha, Ch, Ch, Aa^Fpa, Ha, Ha, Ms, Ha
Gg^Fp, Gg^Fp, Gg, 4 Kh, Ch, Ch, Gg, Ww, Ww^Bw/, Ww^Bw/, Aa, Rd, Rd, Ha, Ha, Ha, Aa^Fpa, Ha, Ha, Ms, Aa^Fpa, Ms, Ha, Rd, Aa, Aa^Fpa, Ai, Ai, Ai, Ai, Ha, Ch, Rr, 3 Kh, Ch, Aa^Fpa, Aa^Fpa, Aa^Fpa
Gg^Fp, Gg^Fp, Gg, Ch, Ch, Ch, Rr, Rr, Hh, Ww, Ww, Aa^Fpa, Aa^Fpa, Rd, Rd, Aa^Fpa, Rd, Aa, Rd, Aa, Rd, Aa^Fpa, Rd, Rd, Rd, Aa, Aa, Ww, Ww, Ww, Aa, Aa, Rr, Rr, Ch, Ch, Ha, Ha
Gg, Gg, Gg^Fp, Gg, Gg, Gg, Rr, Mm, Gg, Ww, Ww, Ha, Ms, Aa, Aa^Vea, Rd, Aa, Rd, Aa^Fpa, Rd, Aa, Rd, Aa^Vha, Aa, Aa^Fpa, Rd, Ww^Bw\, Ww, Aa, Aa^Fpa, Aa^Vha, Rr, Ha, Aa, Aa^Fpa, Ha, Ha^Vhha, Ha
Gg^Fp, Gg^Fp, Gg, Gg, Rd, Rd, Gg, Rr, Rr, Gg^Fp, Gg^Fp, Ww, Ww, Ww, Wwf, Rd, Wwf, Aa, Ww, Ha, Wwf, Wwf, Wwf, Ww, Ww, Aa, Ww, Ww^Bw\, Rd, Ha, Rr, Rr, Rd, Rd, Rd, Rd, Aa^Fpa, Aa^Fpa
Gg^Tf, Gg, Hh^Vhh, Rd, Ss, Gg, Hh, Gg^Fp, Gg, Rr, Rr, Hh, Hh, Ha, Aa, Wwf, Aa, Ww, Aa^Fpa, Ww, Aa, Rd, Aa, Ha, Ms, Ww, Ww, Aa, Ha, Rr, Aa^Fpa, Ms, Rd, Aa^Fpa, Aa, Wwf, Ai, Ai
Hh, Hh, Gg^Fp, Rd, Ss, Hh, Mm, Mm, Gg, Gg, Rr, Gg^Fp, Gg^Vh, Gg, Rd, Rd, Rd, Ha, Rd, Aa^Fpa, Rd, Rd, Gg, Ha, Wwf, Ww, Ww, Aa^Fpa, Ms, Rr, Rd, Aa^Fpa, Rd, Aa, Ww, Ww, Ha, Ha
Hh, Hh, Gg, Rd, Gg, Gg^Fp, Gg, Gg^Tf, Re, Re, Gg, Rr, Rr, Rd, Gg^Tf, Gg, Gg^Fp, Rd, Gg^Ve, Rd, Gg, Gg, Gg, Wwf, Wwf, Wwf, Aa, Aa, Rr, Rr, Aa, Rd, Aa, Ww^Bw\, Gg, Aa, Ha, Ha
Gg^Fp, Gg^Fp, Gg^Tf, Rd, Rd, Gg, Re, Re, Gg, Gg, Hh, Gg^Fp, Rr, Gg, Hh, Ss, Ww, Hh, Gg^Fp, Hh, Ww, Ww, Ww, Wwf, Wwf, Ha, Aa, Rr, Aa^Vea, Ha, Aa, Aa^Fpa, Ha, Ww, Gg^Ve, Re, Aa, Aa
Mm^Xm, Mm^Xm, Mm, Hh, Gg, Re, Gg^Vh, Gg^Fp, Gg^Tf, Gg, Mm, Gg^Fp, Rr, Gg, Ww, Ww, Wo, Ww, Ww, Ww, Wo, Wo, Ww, Ww, Mm, Hh, Rr, Rr, Rd, Aa^Fpa, Aa, Aa^Fpa, Ww, Ww, Gg, Re, Gg, Gg
Mm^Xm, Mm^Xm, Mm, Gg^Fp, Gg, Re, Hh, Gg^Fp, Hh, Gg^Fp, Ss, Gg, Rr, Gg, Ww, Wo, Ww, Ww, Ww, Ww, Ww, Ww, Gg, Gg^Fp, Rr, Rr, Gg^Tf, Hh, Mm, Rd, Gg, Ha, Wwf, Gg, Re, Re, Gg^Fp, Gg^Fp
Mm, Mm, Hh, Ss, Gg, Re, Re, Mm, Gg^Fp, Ss, Ww, Ww, Ww^Bw|, Ww, Ww, Ww, Gg^Vh, Gg^Fp, Gg, Gg, Hh, Gg, Rr, Rr, Gg, Gg, Gg, Hh, Rd, Rd, Gg, Gg, Wwf, Gg, Re, Gg^Fp, Mm, Mm
Hh, Hh, Gg^Fp, Ss, Hh, Gg^Fp, Gg, Re, Gg, Ww, Ww, Ww, Rr, Ww, Gg, Hh, Gg^Fp, Rd, Rd^Tf, Rd, Rr, Rr, Gg, Gg, Gg^Fp, Mm, Ww, Gg, Rd, Gg^Fp, Gg, Gg, Ww, Hh, Re, Gg, Hh, Hh
Ww, Ww, Ww, Ww^Vm, Hh, Gg^Fp, Gg, Re, Gg, Ww, Ww, Gg, Rr, Gg, Rr, Gg, Rr, Hh, Mm, Gg^Fp, Rr, Gg, Gg, Hh, Hh, Ww, Ww, Gg, Gg, Rd, Hh, Mm, Ww, Gg, Gg, Re, Gg^Fp, Gg^Fp
Ww, Ww, Ww, Ww, Ww, Ww, Ww, Re, Ww, Ww, Ww, Gg^Fp, Hh^Vhh, Rr, Gg, Rr, Gg^Ve, Rr, Rr, Rr, Gg^Fp, Rr, Rr, Gg^Fp, Hh^Vhh, Gg^Fp, Mm, Gg^Fp, Hh^Vhh, Rd, Gg^Fp, Hh, Gg, Ww, Gg, Re, Gg, Gg^Tf
Wo, Wo, Wo, Wo, Wo, Ww, Ww, Ww^Bw|, Ww, Ww, Ss, Ss, Hh, Hh, Hh, Rr, Hh, Gg^Fp, Cud, Mm, Hh, Gg^Ve, Rr, Gg, Rd, Hh, Mm, Hh, Rd, Rd, Gg, Gg^Fp, Gg, Wwf, Wwf, Re, Gg, Gg
Wo, Wo, Wo, Wo, Ww, Ww, Gg, Re, Gg, Ss, Gg, Gg^Fp, Hh, Mm, Rr, Rr, Hh, Cud, Kud, Cud, Mm, Rr, Gg, Rd, Hh, Gg^Fp, Gg^Tf, Gg, Rd, Gg^Fp, Gg^Tf, Gg, Re, Re, Wwf, Gg, Hh, Hh
Wo, Wo, Ww, Ww, Ww, Ss, Gg^Fp, Re, Gg, Gg, Gg^Fp, Gg^Tf, Gg^Fp, Rr, Mm, Gg^Tf, Gg^Fp, Cud, Cud, Cud, Hh, Rr, Gg, Hh, Mm, Mm, Mm, Gg, Rd, Hh, Gg, Gg, Re, Gg^Vh, Gg^Fp, Ww, Mm^Xm, Mm^Xm
Wo, Wo, Ww, Ww, Ss, Ss^Vhs, Re, Re, Re, Gg^Fp, Re, Hh, Rr, Rr, Rr, Gg^Fp, Gg^Ve, Hh, Rr, Gg^Fp, Gg^Ve, Rr, Gg, Gg^Fp, Gg^Tf, Mm, Hh, Gg^Fp, Hh, Rd, Mm, Gg^Fp, Re, Hh, Mm, Ss, Mm^Xm, Mm^Xm
Ww, Ww, Ww, Ss, Gs, Hh, Re, Gg, Mm, Re, Gs, Rr, Gg^Vh, Hh, Gg, Rr, Rr, Rr, Hh, Rr, Rr, Rr, Rr, Re, Re, Re, Re, Gg^Fp, Gg, Rd, Hh, Hh, Re, Gg, Ss, Ss, Hh, Hh
Ww, Ww, Ss, Mm, Re, Re, Gs^Ft, Hh, Gs, Gs, Gs^Ft, Rr, Rr, Gg^Fp, Gg, Gg, Gg, Hh, Mm, Gg^Fp, Gg, Hh, Rr, Gg^Vh, Gg, Gg^Fp, Hh, Re, Re, Re, Re, Re, Gg, Ww^Bw\, Re, Gg, Gg^Tf, Gg
Ss, Ss, Ss, Gs^Tf, Re, Gs^Ft, Ss, Ss, Gs, Ss, Hh, Gs, Rr, Gg, Gg, Gg^Fp, Hh, Gg^Fp, Ww, Hh, Gg^Tf, Gg, Gg, Rr, Md, Md, Hd, Gs^Tf, Rd, Gg^Fp, Hh, Gg^Fp, Ww, Ss, Gg, Re, Gg^Fp, Gg^Fp
Ss, Ss, Ss^Vhs, Hh, Re, Gs, Ss, Gs, Ss, Ss, Gs^Tf, Rd, Gs, Rr, Rr, Hh, Gg^Fp, Ww, Ww^Vm, Ww, Gg^Fp, Gg, Gs, Rr, Rr, Hd, Dd, Dd, Rd, Hh, Mm, Ww, Ss, Gg, Re, Re, Tb^Tf, Hh
Ss, Ss, Gs^Ft, Re, Gs, Gs^Ft, Ss, Gs, Ss, Gs^Ft, Rd, Rd, Gs, Gs, Rr, Mm, Gg^Fp, Ww, Ww, Ww, Hh, Gg, Hh, Dd, Rr, Dd, Hd, Rd, Dd^Vdt, Dd, Hh, Ww, Ww, Gg, Re, Gg^Fp, Mm, Mm
Ss, Ss, Gs^Ft, Re, Gs, Mm, Gs^Ft, Gs, Ss^Vhs, Gs^Ft, Rd, Gs, Gs^Ft, Gs^Ft, Rr, Hh, Hh, Mm, Ww, Mm, Hh, Gg^Fp, Hh, Dd, Rr, Dd, Md, Rd, Dd, Dd, Gs, Mm, Ww, Gg, Re, Hh, Gg^Fp, Hh
Ss, Ss, Gs^Tf, Re, Re, Gs, Ss, Ss, Hh, Rd, Gs, Hh, Hh, Gs^Vht, Rr, Gs, Gs, Gs, Wwf, Hh, Hh, Mm, Gg, Gs, Dd, Rr, Rr, Rd, Dd^Tf, Gs, Ww, Ww, Ww, Gg^Fp, Gg^Ve, Re, Gg, Gg
Mm^Xm, Mm^Xm, Mm, Gs, Re, Gs^Ft, Gs^Ft, Ss, Gs, Rd, Gs, Mm, Gs^Ft, Rr, Gs, Hh, Gs^Ft, Gs, Ds, Wwf, Gg, Gg, Gg, Gs, Hh, Dd, Rr, Dd, Hd, Hh, Hh, Ww, Ww, Ww, Hh, Re, Gg, Gg^Tf
Hh, Hh, Gs^Ft, Gs, Re, Gs, Mm, Gs, Rd, Rd, Hh, Gs, Rr, Rr, Hh, Mm, Gs, Gs, Ds, Wwf, Mm, Gg^Fp, Gg^Fp, Gg, Gs, Hd, Rr, Dd, Hd, Mm, Gg^Fp, Hh, Ww, Ww, Gg, Re, Gg, Gg
Hh, Hh, Gs, Re, Gs^Ft, Gs^Tf, Mm, Hh, Rd, Gs^Ft, Gs, Gs^Ft, Rr, Gs, Gs^Vht, Gs^Ft, Re, Re, Wwf, Wwf, Gg^Tf, Gg^Fp, Hh, Gg, Gg, Gs, Rr, Dd, Dd, Mm, Ww, Ww, Ww, Ww, Gg^Fp, Re, Gg, Gg
Gs, Gs, Gs, Re, Gs^Vht, Hh, Hh, Gs, Rr, Gs^Ft, Rr, Rr, Gs, Re, Re, Re, Gs^Ft, Gs, Wwf, Re, Re, Hh^Vhh, Re, Gg, Gg, Gs, Rr, Dd^Vda, Dd, Hh, Ww, Ww, Ww, Gg, Re, Re, Gg^Fp, Gg^Fp
Gs^Ft, Gs^Ft, Ch, Rr, Rr, Gs, Rr, Rr, Ds, Rr, Mm, Mm, Gs^Tf, Gs^Ft, Mm, Mm, Mm, Hh, Ww, Ds, Gs, Re, Gs^Ft, Re, Re, Re, Dd, Rr, Rr, Hh, Gs, Ww, Gs, Gg, Rr, Hh^Vhh, Hh, Hh
Gs^Ft, Gs^Ft, Ch, Ch, Rr, Rr, Gs, Ds, Ww, Mm, Gs^Ft, Hh, Gs^Ft, Gs^Ft, Hh, Mm, Ds, Ww, Ww, Ds, Gs^Tf, Gs^Ft, Ss, Gs, Gs^Ft, Gs, Hh, Dd, Dd, Rr, Gs, Gs^Ft, Rr, Rr, Ch, Hh, Mm, Mm
Hh, Hh, Tb^Tf, 1 Kh, Ch, Rr, Gs, Hh, Ww, Ww, Ww, Hh, Hh, Ds, Mm, Hh, Ww, Ww, Ww, Gs^Ft, Hh, Hh, Ww, Ss, Hh, Gs, Mm, Hh, Rd, Rr, Rr, Rr, Ch, Ch, Ch, Gs^Ft, Gs^Ft, Gs^Ft
Gs^Ft, Gs^Ft, Gs^Ft, Ch, Ch, Rr, Gs, Ww, Ww, Ww^Vm, Ww, Mm, Ww, Ww, Ww, Hh, Ww, Ww, Ww, Ww, Ww, Mm, Ww, Gs^Ft, Mm, Gs^Tf, Gs^Ft, Rd, Gs^Ft, Gs^Tf, Gs^Ft, Ch, Ch, 2 Kh, Hh, Gs^Tf, Mm^Xm, Mm^Xm
Mm^Xm, Mm^Xm, Mm^Xm, Gs^Ft, Hh, Gs^Ft, Hh, Ds, Ww, Ww, Wo, Ww, Ww, Wo, Wo, Ww, Wo, Wo, Ww, Ww^Vm, Ww, Ww, Wo, Ww, Ww, Ss, Ss, Ss^Vhs, Ss, Hh, Ss, Gs^Ft, Gs^Ft, Mm, Mm, Mm, Mm^Xm, Mm^Xm
Mm^Xm, Mm^Xm, Mm^Xm, Gs^Ft, Hh, Gs^Ft, Hh, Ds, Ds, Ww, Wo, Wo, Wo, Wo, Wo, Wo, Wo, Wo, Wo, Ww, Wo, Wo, Wo, Wo, Ww, Ss, Ss, Ss, Ss, Hh, Ss, Gs^Ft, Gs^Ft, Mm, Mm, Mm, Mm^Xm, Mm^Xm
